R    480     640

NO ./path_to_the_north_texture
SO       ./path_to_the_south_texture


WE ./path_to_the_west_texture
EA    ./path_to_the_east_texture


S ./path_to_the_sprite_texture
F                220    ,100,      0
C 225 ,30,      0


111111111111111111111111111111
110000W001100000000000011
10110000011100000020000011
10010000000000000000000011111111
111111111011000001110000000000001
100000000011000001110111111111111
11110111111111011100000010001
11110111111111011101010000001
1100000011010101110000001000111
  1000200000000000110000001000111
  1000000000000000000110101001000111
110000011101010111110111100111111
11110111 1110101 101111010001
11111111 1111111 1111111111111